TTTTTTTTTTTTTTTTTTTTTTTTTTTTTTTTTTTTTTTTTTTTTTTTTTTTTTTTTTTTTTTTTTTTTTTTTTTTTTTT
T..............................................................................T
T..............................................................................T
T....###########...^^^^^^...........#............................###########...T
T....#FFFFFFFFF#...^^^^^^.........#####.........................#IIIIIIIIIIV#..T
T....#FFFFFFFFF#...^^^^^^........###V###........................#IIIIIIIIIII#..T
T....#FFFFFFFFF#...^^^^^^..........:::..........................#IIIIIIIIIII#..T
T....#FFFFFFFFF+::::::::::::...:::::::::::...............########=======I===#..T
T....#FFFFFFFFF#..:^^^^^^..:::::.........:::............#IIIIIIIIIIIIIIIIIII#..T
T....#FFFFFFFFF#..:^^^^^^..................:::::........#IIIIIIIIIIIIIIIIIII#..T
T....#FFFFFFFFF#..:^^^^^^......................:........#IIIIIIIIIIIIIIIIIII#..T
T....#FFFFFFFFF#..:^^^^^^......................:........#IIIIIIIIIIIIIIIIIII#..T
T....#FFFFFFFFF#..:............................:........#IIIIIIIIIIIIIIIIIII#..T
T....###########..:......::::::::::::::........::........#########+#########...T
T....farm.::::::::::::::::....ww......::........:........inn:::::::::..........T
T.................:........wwwwwwww....::.......::...............:.............T
T.................:.......wwwwwwwwww....::.......:...............:.............T
T.................:.......wwwwwwwwww.....:::::::::::::::::::::::::.............T
T.................:........wwwwwwww...............:..........:.................T
T.................:.......wwwwwwwwww..............:..........:.................T
T.................::......wwwwwwwwww..............:..........:.................T
T..................:.......wwwwwwwwww.............:........:::.................T
T..................::......wwwwwwwwww.........####:#####...:...................T
T...................::......wwwwwwww..........#PPPPPPPP#...:...................T
T....................:........:ww:.. .........#PPPPPPPP#.:::...................T
T....................:::::::::::::............#PPPPPPPP#.:.....................T
T...............................:.............#PPP@PPPP#.:.....................T
T...............................:.............#PPPPPPPP#.:.....................T
T...............................:.............#PPPPPPPP#.:.....................T
T....##############.............:.............##########.:.....................T
T...#CCCCCCCCCCCCCC#............::::::::::::::home::::::::.....................T
T...#CCCCCCCCCCCCCC#...................................:.......................T
T...#CCCCCCCCCCCCCC#...................................:.......................T
T...#CCCCCCMCCCCCCC#...................................:......###..............T
T...#CCCCCCCCCCCCCC#...................................:.....#AAA#.............T
T...#CCCCCCCCCCCCCC#...................................:....#AAAAA#............T
T...#CCCCCCCCCCCCCC#...................................:...#AAAAAAA#...........T
T...#CCCCCCCCCCCCCC#...................................:..#AAAAAAAAA#..........T
T....######+#######.......................::::::::::::::..#AAAAAAAAA#..........T
T....cartographer::::::::::::::::::::::::::............:..#AAAAAAAAA#..........T
T......................................................:...#AAAAAAA#...........T
T......................................................:....###+###............T
T......................................................:::::apothecary.........T
T..............................................................................T
TTTTTTTTTTTTTTTTTTTTTTTTTTTTTTTTTTTTTTTTTTTTTTTTTTTTTTTTTTTTTTTTTTTTTTTTTTTTTTTT
